xxxxxxxxxx00000000000000000000xxxxxxxxxx
x00000000000000000000000000000000000000x
x00000000000000000000000000000000000000x
x00000000000000000000000000000000000000x
x00000000000000000000000000000000000000x
x00000000011111100000000111111000000000x
x00000000011111100000000111111000000000x
x00000000011111100000000111111000000000x
0000000000000000000000000000000000000000
0000000000000000000000000000000000000000
0000000000000000000000000000000000000000
x00000000011111100000000111111000000000x
x00000000011111100000000111111000000000x
x00000000011111100000000111111000000000x
x00000000011111100000000111111000000000x
x00000000011111100000000111111000000000x
x00000000011111100000000111111000000000x
x00000000011111100000000111111000000000x
x00000000011111100000000111111000000000x
0000000000000000000000000000000000000000
0000000000000000000000000000000000000000
0000000000000000000000000000000000000000
x00000000011111100000000111111000000000x
x00000000011111100000000111111000000000x
x00000000011111100000000111111000000000x
x00000000000000000000000000000000000000x
x00000000000000000000000000000000000000x
x00000000000000000000000000000000000000x
x00000000000000000000000000000000000000x
xxxxxxxxxx00000000000000000000xxxxxxxxxx

